NEWMAP  //
5
5
11111
101A1
10001
10001
11111
1
1
1