NEWMAP
7 7
XXXXXXX
X0X000X
X0X0X0X
X0X0X0X
X0X0X0X
X000XAX
XXXXXXX
ROBOTS
a P 1 1 5 5