NEWMAP
7 7
XXXXXXX
X0X000X
X0X0X0X
X0X0X0X
X0X0XAX
X000XBX
XXXXXXX
ROBOTS
a P 1 1 4 5
b P 2 1 5 5
NEWMAP
7 7
XXXXXXX
X0X000X
X0X0X0X
X0X0X0X
X0X0X0X
X0000AX
XXXXXXX
ROBOTS
a P 1 1 5 5
b H 4 3 3 5